{
"name": "Level One",
"Moves": 10,
"rows": 0,
"columns": 0,
"PowerUps": [{"PowerUp": 0, "Count": 1}, {"PowerUp": 1, "Count": 1}],
"data": "##########
#        #
# #    o #
# x      #
#        #
#    #   #
#    #   #
#    #   #
#    #   #
#    #   #
#    #   #
#    @#  #
#        #
#        #
##########"
}